0000111111111111111111111111111111111111111111111111111111111111111111111111111111111111111111111111
0000000000000000000000000000000000000000000000000000000000000000000000000000000000000000000000000001
0000111110111111101111111011111110111111101111111011111110111111101111111011111110111111101111111011
0000111110111111101111111011111110111111101111111011111110111111101111111011111110111111101111111011
1011111110111111101111111011111110111111101111111011111110111111101111111011111110111111101111111011
1000000000000000000000000000000000000000000000000000000000000000000000000000000000000000000000000001
1011111110111111101111111011111110111111101111111011111110111111101111111011111110111111101111111011
1011111110111111101111111011111110111111101111111011111110111111101111111011111110111111101111111011
1011111110111111101111111011111110111111101111111011111110111111101111111011111110111111101111111011
1000000000000000000000000000000000000000000000000000000000000000000000000000000000000000000000000001
1011111110111111101111111011111110111111101111111011111110111111101111111011111110111111101111111011
1011111110111111101111111011111110111111101111111011111110111111101111111011111110111111101111111011
1011111110111111101111111011111110111111101111111011111110111111101111111011111110111111101111111011
1000000000000000000000000000000000000000000000000000000000000000000000000000000000000000000000000001
1011111110111111101111111011111110111111101111111011111110111111101111111011111110111111101111111011
1011111110111111101111111011111110111111101111111011111110111111101111111011111110111111101111111011
1011111110111111101111111011111110111111101111111011111110111111101111111011111110111111101111111011
1000000000000000000000000000000000000000000000000000000000000000000000000000000000000000000000000001
1011111110111111101111111011111110111111101111111011111110111111101111111011111110111111101111111011
1011111110111111101111111011111110111111101111111011111110111111101111111011111110111111101111111011
1011111110111111101111111011111110111111101111111011111110111111101111111011111110111111101111111011
1000000000000000000000000000000000000000000000000000000000000000000000000000000000000000000000000001
1011111110111111101111111011111110111111101111111011111110111111101111111011111110111111101111111011
1011111110111111101111111011111110111111101111111011111110111111101111111011111110111111101111111011
1011111110111111101111111011111110111111101111111011111110111111101111111011111110111111101111111011
1000000000000000000000000000000000000000000000000000000000000000000000000000000000000000000000000001
1011111110111111101111111011111110111111101111111011111110111111101111111011111110111111101111111011
1011111110111111101111111011111110111111101111111011111110111111101111111011111110111111101111111011
1011111110111111101111111011111110111111101111111011111110111111101111111011111110111111101111111011
1000000000000000000000000000000000000000000000000000000000000000000000000000000000000000000000000001
1011111110111111101111111011111110111111101111111011111110111111101111111011111110111111101111111011
1011111110111111101111111011111110111111101111111011111110111111101111111011111110111111101111111011
1011111110111111101111111011111110111111101111111011111110111111101111111011111110111111101111111011
1000000000000000000000000000000000000000000000000000000000000000000000000000000000000000000000000001
1011111110111111101111111011111110111111101111111011111110111111101111111011111110111111101111111011
1011111110111111101111111011111110111111101111111011111110111111101111111011111110111111101111111011
1011111110111111101111111011111110111111101111111011111110111111101111111011111110111111101111111011
1000000000000000000000000000000000000000000000000000000000000000000000000000000000000000000000000001
1011111110111111101111111011111110111111101111111011111110111111101111111011111110111111101111111011
1011111110111111101111111011111110111111101111111011111110111111101111111011111110111111101111111011
1011111110111111101111111011111110111111101111111011111110111111101111111011111110111111101111111011
1000000000000000000000000000000000000000000000000000000000000000000000000000000000000000000000000001
1011111110111111101111111011111110111111101111111011111110111111101111111011111110111111101111111011
1011111110111111101111111011111110111111101111111011111110111111101111111011111110111111101111111011
1011111110111111101111111011111110111111101111111011111110111111101111111011111110111111101111111011
1000000000000000000000000000000000000000000000000000000000000000000000000000000000000000000000000001
1011111110111111101111111011111110111111101111111011111110111111101111111011111110111111101111111011
1011111110111111101111111011111110111111101111111011111110111111101111111011111110111111101111111011
1011111110111111101111111011111110111111101111111011111110111111101111111011111110111111101111111011
1000000000000000000000000000000000000000000000000000000000000000000000000000000000000000000000000001
1011111110111111101111111011111110111111101111111011111110111111101111111011111110111111101111111011
1011111110111111101111111011111110111111101111111011111110111111101111111011111110111111101111111011
1011111110111111101111111011111110111111101111111011111110111111101111111011111110111111101111111011
1000000000000000000000000000000000000000000000000000000000000000000000000000000000000000000000000001
1011111110111111101111111011111110111111101111111011111110111111101111111011111110111111101111111011
1011111110111111101111111011111110111111101111111011111110111111101111111011111110111111101111111011
1011111110111111101111111011111110111111101111111011111110111111101111111011111110111111101111111011
1000000000000000000000000000000000000000000000000000000000000000000000000000000000000000000000000001
1011111110111111101111111011111110111111101111111011111110111111101111111011111110111111101111111011
1011111110111111101111111011111110111111101111111011111110111111101111111011111110111111101111111011
1011111110111111101111111011111110111111101111111011111110111111101111111011111110111111101111111011
1000000000000000000000000000000000000000000000000000000000000000000000000000000000000000000000000001
1011111110111111101111111011111110111111101111111011111110111111101111111011111110111111101111111011
1011111110111111101111111011111110111111101111111011111110111111101111111011111110111111101111111011
1011111110111111101111111011111110111111101111111011111110111111101111111011111110111111101111111011
1000000000000000000000000000000000000000000000000000000000000000000000000000000000000000000000000001
1011111110111111101111111011111110111111101111111011111110111111101111111011111110111111101111111011
1011111110111111101111111011111110111111101111111011111110111111101111111011111110111111101111111011
1011111110111111101111111011111110111111101111111011111110111111101111111011111110111111101111111011
1000000000000000000000000000000000000000000000000000000000000000000000000000000000000000000000000001
1011111110111111101111111011111110111111101111111011111110111111101111111011111110111111101111111011
1011111110111111101111111011111110111111101111111011111110111111101111111011111110111111101111111011
1011111110111111101111111011111110111111101111111011111110111111101111111011111110111111101111111011
1000000000000000000000000000000000000000000000000000000000000000000000000000000000000000000000000001
1011111110111111101111111011111110111111101111111011111110111111101111111011111110111111101111111011
1011111110111111101111111011111110111111101111111011111110111111101111111011111110111111101111111011
1011111110111111101111111011111110111111101111111011111110111111101111111011111110111111101111111011
1000000000000000000000000000000000000000000000000000000000000000000000000000000000000000000000000001
1011111110111111101111111011111110111111101111111011111110111111101111111011111110111111101111111011
1011111110111111101111111011111110111111101111111011111110111111101111111011111110111111101111111011
1011111110111111101111111011111110111111101111111011111110111111101111111011111110111111101111111011
1000000000000000000000000000000000000000000000000000000000000000000000000000000000000000000000000001
1011111110111111101111111011111110111111101111111011111110111111101111111011111110111111101111111011
1011111110111111101111111011111110111111101111111011111110111111101111111011111110111111101111111011
1011111110111111101111111011111110111111101111111011111110111111101111111011111110111111101111111011
1000000000000000000000000000000000000000000000000000000000000000000000000000000000000000000000000001
1011111110111111101111111011111110111111101111111011111110111111101111111011111110111111101111111011
1011111110111111101111111011111110111111101111111011111110111111101111111011111110111111101111111011
1011111110111111101111111011111110111111101111111011111110111111101111111011111110111111101111111011
1000000000000000000000000000000000000000000000000000000000000000000000000000000000000000000000000001
1011111110111111101111111011111110111111101111111011111110111111101111111011111110111111101111111011
1011111110111111101111111011111110111111101111111011111110111111101111111011111110111111101111111011
1011111110111111101111111011111110111111101111111011111110111111101111111011111110111111101111111011
1000000000000000000000000000000000000000000000000000000000000000000000000000000000000000000000000001
1011111110111111101111111011111110111111101111111011111110111111101111111011111110111111101111111011
1011111110111111101111111011111110111111101111111011111110111111101111111011111110111111101111111011
1011111110111111101111111011111110111111101111111011111110111111101111111011111110111111101111110000
1000000000000000000000000000000000000000000000000000000000000000000000000000000000000000000000000000
1011111110111111101111111011111110111111101111111011111110111111101111111011111110111111101111110000
1111111111111111111111111111111111111111111111111111111111111111111111111111111111111111111111110000
