0000011111111111111111111111111111111111111111111111111111111111111111111111111111111111111111111111
0000000010100110000010001001100000000000001001010000000001010000000010000000000000000000011100010001
0000000001000000100000100001010000100101001000000000000001000001000010001000001100000010000100000001
0000000010001000000000010000010001011000100000000000000001000100000010000010000111000000000010010001
0000010000011000000010000100000100000000100000000110000000001010010000000001000000100000000001000001
1001000000000011000000011000100100001001010010000000000000000000000001000010001000000000001000000001
1000100010101001010100000000110000000011110000010010011000001001000100000000010000000000000000100001
1010100000010100000001000000000000111001000000110110000010000001100001011000100000000000000000111101
1000000000000000001100001000001100010000000100001000100000000000000000000100000000010001001000100001
1000000000000000000000100000010000100000000100000000001000000000000011000001000001000100011000010001
1100010000000100000000000001000000000000000000001001100000000000101000000001000000010100001000010001
1101000000101000100001000001100000100101000001010110101100011000000100100000100000110100000000100001
1000000010001010110000001000000000000100000000001000100010001010000000011100000000100000100100100101
1100000101100000011000001000000001010000000110001000000000001100010001010000000000000111000010000101
1000000110000000010000000000000000000100001101000100101000100000000000000000000000100001000000100001
1011000010000100010011000001001000100100100000101000000000100000001001000001000111000000100001000001
1000000010000100000010000001000001001100000000000000100000000000100001000010000000010101000001000001
1010000000010001111000000000100010100000011000000000000001100000000010000001000001000000001000001001
1000000000001010000010000001001100000001000000000000000010000000100010101101000000110000010000000011
1000000000000010000000000000000010000001001010000001000010000010100000000101000000001110010000100001
1101100000000100110000001000011000000000001001010001001001000001000000010100101000000000000000010001
1011000000000010000101100100000100000000010001000000000000100000000000100000101000010000000100100001
1000000000010000000010000100000000000101000001100000000100000001010001000011110000000000000010011101
1000010100001100010000000110000001000010000000100000000100011000011000110001010000010000101001000101
1000110000000000100000000000000100000000000000000000100000000000010000100000010000000000011001010001
1000000010001001100001001010000001101000000000000000011101000101000000100101100000000110000100001101
1000100010000000000000000110010000000000100000100000000000001000000100000010000000000001100100100011
1010000001000000101001000011001001001010100001000110000010100000000000010001000000100000001101100001
1001000000000000100011000000100100001100001001001000000100001000010000000000100010001000001000000001
1100010000001000100010010000001110100000000000100011000000011000100100000010000001100100000001100101
1001010001010100100000101100000000000001000010000010000100000001000010000100000100010010000100000001
1001011000010000001001000000100000010001010000001011000000010000110000110000100010101101000000100101
1000011101000001010000000100100000000000001000000010100010000000001000000000001000001000000010100101
1000001000001010000001000000010010011000000000011001000100000100000001001000100000000000001000000011
1100000001000000000000010010000000000111000100100000000000010000010100000000001010010001000001101001
1100000100100000000000100000100100100010001000001000000010101111100000100001000011001000001110000101
1100100001010000000010101000010010001010100000000000010000000010100010001000000000100100110000000011
1000000010000000011100101000001000000001001000001001000000000000100000000000000000000100000000000111
1010100000010100000000000000001000000000000001011000010000110100000000011000100000000001000000000001
1000000010100100110000100000001001100000000100000001010010000001000010000000011000000000010011000001
1000110001010000000000010000010000001000100011101000000000000000000000010010000000010100000100000001
1010000000000000011100100100000010110101010100010001000100001000000001000011001001010000000100000001
1001100000010001100001000000000000000000000001000000101110010110000000000000010001101100000001100001
1000100001100000000000000001110000000100100100000000010000001100000010000000000001000000100001000001
1000000000001100100001010100000000000100000000011001001000000000110000011000000000000110000111100101
1010100000010100000000001000000000000001000010001000100001000000000000000100000111011000010000000001
1010101000100000100000000010000100010010101100001110000100010000001001000001100000011000100110000001
1000000010101000100000000100001010000000110001001000100100000110010000000000000000000000000000100001
1001101000010000010000000011000000000100010100100000000110101001100010001000100000100000110100011001
1001010100000001010011000101000001000001000100010000100000000000100100100000010000010000001001000001
1100000000000001100000000000000001110100000100000000100000000000010000000100000001010001000100100001
1000001100000000000001010000001100000010000010000001101000001010000010001000100010000001000000000001
1001000010001101000000010000001000011000000000000000000000000001000000000010000000100001001000010001
1010000100010100000001000110100000100010001001101000000000000010000000000000000001000100110000000001
1000000000000100000001011000001000011100010000000001100100010000000000000010001001110000100000010001
1010000000000010010000010100010001000000000010000101100001000100111010000000011010000000000011000001
1000101000001000000001000000100100011100011100000010100000000000000001100010000001010000011000010001
1000000000000100000000001001000110100001001100010000001101100000100110001011100010010000000000010001
1001100000110001011100000000000011000001010100000001000010100000010010010000100001000000010001000011
1011001000000100100000000000001010100100000001001001000001000000000100100000010010001000101000010001
1000000001000100000000010010001000000000100001000000000000010100001001000000010101010100001000010011
1000000000100000010000011000001000101000001000000010000000001010000100100000011001000001100000000001
1100100000001000110011000000000110000000010010000011010000000101000000000001000101110010011001101001
1000010100001000010101000010000000100001011100010100000000110001001001100100100001000000000000000101
1001111000010110000000000010000001000001001000000000000001100010010000000010010000000000000100000001
1000000010000101010000000000000011000000000000000011000001000000011000000111000100010100000010011001
1000000010000000110000000000000000100000000000001000000010000000001000000000000000001100010001100001
1000000000010100000000001010001001000001010000100000001000000011000000011000000001000000000000100111
1110000000000000010001101000001000000110110000000001000100000011000001000000000100110001001010000101
1000010000000000000100001000000011000011110100001010110100000000011000101110000000000000111100000001
1010001110000000011000000000000000000010000000101000000001000000000000011010000110010011001000010011
1000000001100001100010000100100000000100001000000000011100100110000100000000000100000000000001010001
1100100011000000110001010000000000000000000000010011000000000000000011010010000000010110000010100001
1010000000000000000000000000000000001010010100101100000000101000001111010010011000000100000011000001
1000000000100000000001000010000000001000011000000000000000010010000000000110000000100100001000100001
1000000100000000001110000010000000000100000000000001110100010100100000010010000000011100110000100001
1100001000000000110101000000001000000010001001000010000000000000100101000000000100111010011110000111
1001000100000000001100100000101000100000010010000000000000001000000000011000000000001000100000111011
1000000000001000000000010000000000010000000101000000000100100000000001100011010011000011010011001001
1100000000001110000000000000000100000100000000000000001100000010000001100001000100111000100100100001
1000000110000010001000001101001000100100001000100001000100000000000000000000000000001001010000000001
1000100000000000001011010100001000010000001001000000100000100000011011100000000000100010000000000001
1100000000000010000000100000000000100010000001100001001100011100000001000000011010010100000000000001
1010010000100000000001000101000000100000000110000100000101000001001000000011001000000000000000111001
1010000110000000000000100000100000010000000000000010100000000000000010010000001100100010000100001011
1100000010000000000000001100010000010000110010100000000100010100110100100000010000000000000100100001
1001010000100001000100000100101110100000010001010000000000100000000011011001000000100000000000001101
1011000000000000000000000000000000000100000010000100000000001000000010101010110100000101001000011101
1001100000000000000111100000000000010000000100001000011000011000000000000001110000110001100000000001
1001010001001000000110000000000100010011000000001000001100000000000110110000000010001000000100001001
1000100000000000010000111010001110011000100000100010110100100000001011001010001010100000011110001001
1001000100001000001101000000100010100000000000000000000000101000100000100000110001000010010110011001
1000000010100100000000010001000100000000100111001001000001000001001000100001001010000010010000010001
1000000000000011000100001100100110000001101000010000000000000010010100100001000010000000110001000001
1010000011000000001000100001000010010000000010101000100100100001000001010000000000011010000000000001
1100000010010000010100000010000000000011000000000100001001000100000000001000100100100000000000000000
1010010010000011010000011100100000100111010100000000000000011000000000000000000001110000000110000000
1010100000000100001000001000011000000000000010110000000000000100111100011000000001010000110100000000
1000000000100000101100110000000100000000101000100001100001010010100000000000001101100001000000000000
1111111111111111111111111111111111111111111111111111111111111111111111111111111111111111111111100000
