11111111111111111111111111111111111111111111111111
10000000000000010000000000000010000000000000000001
10000000000000010000000000000010000000000000000001
10000000000000010000000000000010000000000000000001
10000000000000010000000000000010000000000000000001
10000000000000010000000000000010000000000000000001
10000000000000010000000000000000000000000000000001
10000000000000010000000000000000000000000000000001
10000000000000010000000000000000000000000000000001
10000000000000010000000000000000000000000000000001
10000000000000010000000000000000000000000000000001
10000000000000010000000000000000000000000000000001
10000000000000010000000000000000000000000000000001
10000000000000010000000000000010000000000000000001
10000000000000010000000000000010000000000000000001
10000000000000010000000000000010000000000000000001
10000000000000010000000000000010000000000000000001
10000000000000010000000000000010000000000000000001
10000000000000010000000000000010000000000000000001
10000000000000010000000000000010000000000000000001
10000000000000000000000000000010000000000000000001
10000000000000000000000000000010000000000000000001
10000000000000000000000000000010000000000000000001
10000000000000000000000000000010000000000000000001
10000000000000000000000000000010000000000000000001
10000000000000000000000000000010000000000000000001
10000000000000010000000000000010000000000000000001
10000000000000010000000000000010000000000000000001
10000000000000010000000000000010000000000000000001
10000000000000010000000000000010000000000000000001
10000000000000010000000000000010000000000000000001
10000000000000010000000000000010000000000000000001
10000000000000010000000000000010000000000000000001
10000000000000010000000000000010000000000000000001
10000000000000010000000000000010000000000000000001
11111111111111111111111111111111111100000000011111
10000000000000010000000000000010000000000000000001
10000000000000010000000000000010000000000000000001
10000000000000010000000000000010000000000000000001
10000000000000010000000000000010000000000000000001
10000000000000010000000000000010000000000000000001
10000000000000010000000000000010000000000000000001
10000000000000010000000000000010000000000000000001
10000000000000010000000000000010000000000000000001
10000000000000010000000000000010000000000000000001
10000000000000010000000000000010000000000000000001
10000000000000010000000000000010000000000000000001
10000000000000010000000000000010000000000000000001
10000000000000010000000000000010000000000000000001
11111111111111111111111111111111111111111111111111
